Note: Do not change the headings in this file, they are used to detect problems		
Status Bar Message	Tool Tip	
Для вызова экрана помощи нажмите F1		
Создать новую карту	Создать карту	
Открыть существующую карту	Открыть карту	
Сохранить текущую карту	Сохранить карту	
Сохранить текущую карту под новым именем	Сохранить карту как	
Вывести информацию о программе, номер версии и уведомление о правах	О программе	
Выйти из редактора карт	Выход	
Список разделов помощи	Разделы помощи	
Вывести на экран файл помощи для текущего задания или команды	Помощь	
Открыть данную карту		
Скопировать выделенный объект и поместить его в буфер обмена	Копировать	
Вырезать выделенный объект и поместить его в буфер обмена	Вырезать	
Найти заданный тип объекта		
Вставить из буфера обмена	Вставить	
Отменить последнее действие	Отменить	
Повторить предыдущее отмененное действие	Повторить	
Изменить размер окна		
Переместить окно		
Свернуть окно		
Открыть окно на весь экран		
Закрыть окно		
Восстановить нормальные размеры окна		
Показать карту подземного уровня	Подземелье	
Показать проходимость объектов на карте	Проходимость	
Разместить ландшафт	Ландшафт	
Разместить реки	Реки	
Разместить дороги	Дороги	
Удалить объекты	Ластик	
Разместить объекты	Объекты: земля	
Разместить песчаные объекты	Объекты: пустыня	
Разместить травяные объекты	Объекты: трава	
Разместить снежные объекты	Объекты: снег	
Разместить болотистые объекты	Объекты: болото	
Разместить каменные объекты	Объекты: камни	
Разместить подземные объекты	Объекты: подземелье	
Разместить лавовые объекты	Объекты: лава	
Разместить водные объекты	Объекты: вода	
Разместить города	Города	
Разместить монстров	Монстры	
Разместить героев	Герои	
Разместить артефакты	Артефакты	
Разместить сокровища	Сокровища	
Анимировать объекты на карте		
Изменить свойства карты		
Выбрать кисть 1x1 для ландшафта	Кисть 1x1	
Выбрать кисть 2x2 для ландшафта	Кисть 2x2	
Выбрать кисть 4x4 для ландшафта	Кисть 4x4	
Выбрать режим заливки ландшафта	Заливка	
Выбрать земляной ландшафт	Земля	
Выбрать пустынный ландшафт	Песок	
Выбрать травянистый ландшафт	Трава	
Выбрать снежный ландшафт	Снег	
Выбрать болотистый ландшафт	Болото	
Выбрать каменистый ландшафт	Камни	
Выбрать подземный ландшафт	Подземелье	
Выбрать вулканический ландшафт	Лава	
Выбрать водное пространство	Вода	
Выбрать обычный тип реки	Чистые реки	
Выбрать реку, покрытую льдом	Реки, покрытые льдом	
Выбрать илистую реку	Илистые реки	
Выбрать лавовую реку	Лавовые реки	
Выбрать гравийную дорогу	Гравийные дороги	
Выбрать мощеную дорогу	Мощеные дороги	
Выбрать ластик в 1x1клетку	Кисть 1x1	
Выбрать ластик в 2x2 клетки	Кисть 2x2	
Выбрать ластик в 4x4 клетки	Кисть 4x4	
Стереть область	Заливка	
Игрок не выбран		
Выбрать %s игрока		
Выбрать земляной тип дороги	Земляные дороги	
Выбрать толщу земли	Скалы	
Удалить выделенный объект	Удалить	
Показать свойства выбранного объекта	Свойства	
Показать сетку	Сетка	
Разместить объекты, общие для всех ландшафтов	Общие объекты	
Выбрать кисть 1x1	Кисть 1x1	
Выбрать кисть 2x2	Кисть 2x2	
Выбрать кисть 4x4	Кисть 4x4	
Выбрать режим заливки	Заливка	
Проверить карту на наличие ошибок	Проверить карту	
Анимировать ландшафт		
Изменить опции применения		
Экспортировать текст из текущей карты в файл		
Импортировать текст из файла в текущую карту		
Описать выбранный объект		
Найти следующий объект заданного типа		
Найти предыдущий объект заданного типа		
Уменьшить карту	Удалить	
Увеличить карту	Приблизить	
Показать или убрать панель инструментов	Панель инструментов	
Показать или убрать строку состояния	Строка состояния	
Показать или убрать панель режимов	Панель режимов	
Размещать препятствия автоматически	Инструмент препятствий	
Выбрать сплошную кисть 1x1	Сплошная кисть 1x1	
Выбрать сплошную кисть 2x2	Сплошная кисть 2x2
Выбрать сплошную кисть 4x4	Сплошная кисть 4x4
Выбрать кисть для создания сплошного фона	Кисть для сплошного фона
Выбрать размытую кисть 1x1	Размытая кисть 1x1
Выбрать размытую кисть 2x2	Размытая кисть 2x2
Выбрать размытую кисть 4x4	Размытая кисть 4x4
Выбрать кисть для создания размытого фона	Кисть для размытого фона
Выбрать четкий ластик 1x1	Четкий ластик 1x1
Выбрать четкий ластик 2x2	Четкий ластик 2x2
Выбрать четкий ластик 4x4	Четкий ластик 4x4
Выбрать ластик для создания четкого фона	Ластик для четкого фона
Выбрать размытый ластик 1x1	Размытый ластик 1x1
Выбрать размытый ластик 2x2	Размытый ластик 2x2
Выбрать размытый ластик 4x4	Размытый ластик 4x4
Выбрать ластик для создания размытого фона	Ластик для размытого фона
Разместить препятствия в указанных местах	Разместить препятствия
Выбрать ластик для рек	Ластик для рек
Выбрать ластик для дорог	Ластик для дорог
