Rollover Text	Right-Click Text																						
Note: Do not change the headings in this file, they are used to detect problems																							
Main Menu																							
	"{Новая игра}

Начать новую игру.
(горячая клавиша – N/Т)"																						
	"{Загрузить игру}

Загрузить сохраненную игру.
(горячая клавиша – L/Д)"																						
	"{Таблица рекордов}

Лучшие результаты прохождения различных сценариев и кампаний.
(горячая клавиша – H/Р)"																						
	"{Авторы}

Показать список создателей игры и авторов локализации.
(горячая клавиша – C/С)"																						
	"{Выйти}

Выйти в Windows.
(горячая клавиша – Esc)"																						
																							
New Game	New Game																						
	"{Сценарий}

Игра по сценарию с участием одного игрока-человека.
(горячая клавиша – S/Ы)"																						
	"{Кампания}

Прохождение группы сценариев, связанных между собой общим сюжетом и персонажами.
(горячая клавиша – C/С)"																						
	"{Сетевая игра}

Игра по сценарию с участием нескольких людей-игроков.
(горячая клавиша – M/Ь)"																						
	"{Обучение}

Игра по обучающему сценарию, демонстрирующему новичкам азы "Героев Меча и Магии III".
(горячая клавиша – T/Е)"																						
	"{Назад}

Вернуться в главное меню игры.
(горячая клавиша – Esc)"																						
																							
Single Scenario Selection	Single Scenario Selection																						
																							
SCENARIO_BACKGROUND 	Выбрать сценарий.																						
ADVANCED_BACKGROUND 	Дополнительные настройки.																						
Background for random map menu	Настроить и создать случайную карту.																						
SCENARIO_NAME 	Название сценария.																						
Description Title	Описание задания сценария.																						
Description text	Описание задания сценария.																						
EASY 	"{Легкая игра}

Игрок начинает с 30000 золота, 30 древесины и руды, 15 ртути, серы, кристаллов и самоцветов, и доходом города на старте в 500 золотых, тогда как компьютер с 5000 золота, 5 древесины и руды, 2 ртути, серы, кристаллов и самоцветов, и доходом города на старте в 375 золотых.

Компьютер играет слабо (50%)
Все герои игрока-человека получают бесплатный, невидимый уровень дипломатии. Компьютер не оценивает опасность вражеских героев, неосторожен с перемещением своих героев, строит здания один раз в два дня, не строит жилища уровней выше, чем есть у игрока, не строит жилища 7 уровня, не занимается поисками Грааля, не консолидирует армии, не обменивается существами и артефактами между своими героями, не берет нейтралов в свою армию, не использует тактические приемы в бою, не ждет и всегда идет в атаку, не нанимает больше 3 героев. Все компьютерные игроки не могут иметь больше 8 героев в сумме."																						
NORMAL 	"{Нормальная игра}

Игрок начинает с 20000 золота, 20 древесины и руды, 10 ртути, серы, кристаллов и самоцветов, и доходом города на старте в 500 золотых, тогда как компьютер с 7500 золота, 10 древесины и руды, 4 ртути, серы, кристаллов и самоцветов, и доходом города на старте в 500 золотых.

Компьютер играет достаточно хорошо (75%)
Компьютер недооценивает опасность вражеских героев, в меру осторожен с перемещением своих героев, строит здания один раз в два дня, но агрессивно, начинает поиски Грааля после открытия половины его карты, делает большой акцент на изучение карты, консолидирует армии, обменивается существами и артефактами между своими героями, не нанимает больше 3 героев. Все компьютерные игроки не могут иметь больше 11 героев в сумме."																						
HARD 	"{Сложная игра}

Игрок начинает с 15000 золота, 15 древесины и руды, 7 ртути, серы, кристаллов и самоцветов, и доходом города на старте в 500 золотых, тогда как компьютер с 10000 золота, 15 древесины и руды, 7 ртути, серы, кристаллов и самоцветов, и доходом города на старте в 500 золотых.

Компьютер играет на пределе своих возможностей (100%)
Компьютер всегда максимально точно оценивает опасность вражеских героев, осторожен с перемещением своих героев, строит здания каждый день, причем очень агрессивно, начинает поиски Грааля после открытия четверти его карты, делает большой акцент на изучение карты, консолидирует армии, обменивается существами и артефактами между своими героями, учитывает дальность хода вражеских войск во время боя и использует эту информацию в тактическом плане, не нанимает больше 4 героев. Все компьютерные игроки не могут иметь больше 14 героев в сумме."																						
EXPERT 	"{Очень сложная игра}

Игрок начинает с 10000 золота, 10 древесины и руды, 4 ртути, серы, кристаллов и самоцветов, и доходом города на старте в 500 золотых, тогда как компьютер с 10000 золота, 15 древесины и руды, 7 ртути, серы, кристаллов и самоцветов, и доходом города на старте в 625 золотых.

Компьютер играет на пределе своих возможностей (100%)
Компьютер всегда максимально точно оценивает опасность вражеских героев, очень осторожен с перемещением своих героев, строит здания каждый день, причем очень агрессивно, начинает поиски Грааля после открытия хотя бы одной части его карты, делает большой акцент на изучение карты, консолидирует армии, обменивается существами и артефактами между своими героями, учитывает дальность хода вражеских войск во время боя и использует эту информацию в тактическом плане, не нанимает больше 5 героев. Все компьютерные игроки не могут иметь больше 17 героев в сумме."																						
IMPOSSIBLE 	"{Сверхсложная игра}

Игрок начинает, не имея ресурсов, и доходом города на старте в 500 золотых, тогда как компьютер с 10000 золота, 15 древесины и руды, 7 ртути, серы, кристаллов и самоцветов, и доходом города на старте в 750 золотых.

Компьютер играет на пределе своих возможностей (100%)
Компьютер всегда максимально точно оценивает опасность вражеских героев, крайне осторожен с перемещением своих героев, строит здания каждый день, причем очень агрессивно, начинает поиски Грааля после открытия хотя бы одной части его карты, делает большой акцент на изучение карты, консолидирует армии, обменивается существами и артефактами между своими героями, учитывает дальность хода вражеских войск во время боя и использует эту информацию в тактическом плане, не нанимает больше 6 героев. Все компьютерные игроки не могут иметь больше 20 героев в сумме."																						
ALLY_FLAG1 	Это ваш цвет флага.																						
ALLY_FLAG2 	Это цвет флага ваших союзников.																						
ALLY_FLAG3 	Это цвет флага ваших союзников.																						
ALLY_FLAG4 	Это цвет флага ваших союзников.
ALLY_FLAG5 	Это цвет флага ваших союзников.
ALLY_FLAG6 	Это цвет флага ваших союзников.
ALLY_FLAG7 	Это цвет флага ваших союзников.
ALLY_FLAG8 	Это цвет флага ваших союзников.
ENEMY_FLAG1 	Это цвет флага ваших врагов.
ENEMY_FLAG2 	Это цвет флага ваших врагов.
ENEMY_FLAG3 	Это цвет флага ваших врагов.
ENEMY_FLAG4 	Это цвет флага ваших врагов.
ENEMY_FLAG5 	Это цвет флага ваших врагов.
ENEMY_FLAG6 	Это цвет флага ваших врагов.
ENEMY_FLAG7 	Это цвет флага ваших врагов.
ENEMY_FLAG8 	Это цвет флага ваших врагов.
SCENARIO_OPTIONS 	Показать/Скрыть список сценариев.
(горячая клавиша – S/Ы)
ADVANCED_OPTIONS 	Показать/Скрыть дополнительные настройки.
(горячая клавиша – A/Ф)
random map button	Показать/Скрыть меню настроек случайной карты.
(горячая клавиша – R/К)
CHAT_DESC 	Переключаться между окном описания сценария и окном чата.
MAP_DIFFICULTY 	Выбор соотношения сил игроков-людей и игроков под управлением компьютера.
RATING 	Общий уровень сложности игры в процентном выражении, зависящий от установок сложности карты и игрока, и влияющий на расчет рейтинга победившего игрока для таблицы рекордов.
MAP_SIZE 	Уровень сложности карты может быть легким, нормальным, сложным, очень сложным или сверхсложным.
VICTORY_CONDITION 	Условия победы для текущего сценария.
LOSS_CONDITION 	Условия поражения для текущего сценария.
SMALL_FILTER 	"Показать все маленькие карты.
(36 х 36 клеток)"
MEDIUM_FILTER 	"Показать все средние карты.
(72 х 72 клетки)"
LARGE_FILTER 	"Показать все большие карты.
(108 х 108 клеток)"
EXTRALARGE_FILTER 	"Показать все очень большие карты.
(144 х 144 клетки)"
ALL_FILTER 	Показать все карты.
SCENARIO_NAME_1 	SCENARIO_NAME_1 
SCENARIO_NAME_2 	SCENARIO_NAME_2 
SCENARIO_NAME_3 	SCENARIO_NAME_3 
SCENARIO_NAME_4 	SCENARIO_NAME_4 
SCENARIO_NAME_5 	SCENARIO_NAME_5 
SCENARIO_NAME_6 	SCENARIO_NAME_6 
SCENARIO_NAME_7 	SCENARIO_NAME_7 
SCENARIO_NAME_8 	SCENARIO_NAME_8 
SCENARIO_NAME_9 	SCENARIO_NAME_9 
SCENARIO_NAME_10 	SCENARIO_NAME_10 
SCENARIO_NAME_11 	SCENARIO_NAME_11 
SCENARIO_NAME_12 	SCENARIO_NAME_12 
SCENARIO_NAME_13 	SCENARIO_NAME_13 
SCENARIO_NAME_14 	SCENARIO_NAME_14 
SCENARIO_NAME_15 	SCENARIO_NAME_15 
SCENARIO_NAME_16 	SCENARIO_NAME_16 
SCENARIO_NAME_17 	SCENARIO_NAME_17 
SCENARIO_NAME_18 	SCENARIO_NAME_18 
ENTRY_SCENARIO_NAME_1 	ENTRY_SCENARIO_NAME_1 
ENTRY_SCENARIO_NAME_2 	ENTRY_SCENARIO_NAME_2 
ENTRY_SCENARIO_NAME_3 	ENTRY_SCENARIO_NAME_3 
ENTRY_SCENARIO_NAME_4 	ENTRY_SCENARIO_NAME_4 
ENTRY_SCENARIO_NAME_5 	ENTRY_SCENARIO_NAME_5 
ENTRY_SCENARIO_NAME_6 	ENTRY_SCENARIO_NAME_6 
ENTRY_SCENARIO_NAME_7 	ENTRY_SCENARIO_NAME_7 
ENTRY_SCENARIO_NAME_8 	ENTRY_SCENARIO_NAME_8 
ENTRY_SCENARIO_NAME_9 	ENTRY_SCENARIO_NAME_9 
ENTRY_SCENARIO_NAME_10 	ENTRY_SCENARIO_NAME_10 
ENTRY_SCENARIO_NAME_11 	ENTRY_SCENARIO_NAME_11 
ENTRY_SCENARIO_NAME_12 	ENTRY_SCENARIO_NAME_12 
ENTRY_SCENARIO_NAME_13 	ENTRY_SCENARIO_NAME_13 
ENTRY_SCENARIO_NAME_14 	ENTRY_SCENARIO_NAME_14 
ENTRY_SCENARIO_NAME_15 	ENTRY_SCENARIO_NAME_15 
ENTRY_SCENARIO_NAME_16 	ENTRY_SCENARIO_NAME_16 
ENTRY_SCENARIO_NAME_17 	ENTRY_SCENARIO_NAME_17 
ENTRY_SCENARIO_NAME_18 	ENTRY_SCENARIO_NAME_18 
TURN_DURATION 	Продолжительность хода.
CHAT_TEXT 	Текстовые сообщения другим игрокам.						
CHAT_ENTRY 	Напечатайте здесь свое сообщение.						
CHAT_PLUG 	CHAT_PLUG 						
CHAT_PLAYER 	Список игроков.						
CHAT_PLAYER_SLIDER,	CHAT_PLAYER_SLIDER,						
ROLLOVER 	ROLLOVER 						
NEXT 	Сохранить текущую игру.						
BEGIN 	"Начать игру на выбранном сценарии.
(горячая клавиша – B/И)
сохранить или загрузить игру.
(горячая клавиша – Enter)
удалить сохраненную игру.
(горячая клавиша – Ctrl+Del)"						
BACK 	Вернуть.						
SSEXIT 	"Закрыть окно; все действия отменяются.
(горячая клавиша – Esc)"						
WHICHMAP 	"Размер текущей карты.
(S – маленькая, M – средняя, L – большая, XL – очень большая)"						
SORT_NUMBER 	Отсортировать карты по количеству игроков.						
SORT_SIZE 	Отсортировать карты по размеру.						
k_sort_version	Отсортировать карты по дополнительным кампаниям.						
SORT_ALPHA 	Отсортировать карты по названию в алфавитном порядке.						
SORT_VICTORY 	Отсортировать карты по условиям победы.						
SORT_LOSS 	Отсортировать карты по условиям поражения.
BRIEFING 	BRIEFING 
SSHERO 	SSHERO 
GOLDPIC 	GOLDPIC 
HUMAN_CPU1 	"""Человек или компьютер"" означает, что под этим цветом флага может играть либо человек, либо компьютер.

""Только компьютер"" означает, что под этим цветом флага может играть только компьютер."
HUMAN_CPU2 	"""Человек или компьютер"" означает, что под этим цветом флага может играть либо человек, либо компьютер.

""Только компьютер"" означает, что под этим цветом флага может играть только компьютер."
HUMAN_CPU3 	"""Человек или компьютер"" означает, что под этим цветом флага может играть либо человек, либо компьютер.

""Только компьютер"" означает, что под этим цветом флага может играть только компьютер."
HUMAN_CPU4 	"""Человек или компьютер"" означает, что под этим цветом флага может играть либо человек, либо компьютер.

""Только компьютер"" означает, что под этим цветом флага может играть только компьютер."
HUMAN_CPU5 	"""Человек или компьютер"" означает, что под этим цветом флага может играть либо человек, либо компьютер.

""Только компьютер"" означает, что под этим цветом флага может играть только компьютер."
HUMAN_CPU6 	"""Человек или компьютер"" означает, что под этим цветом флага может играть либо человек, либо компьютер.

""Только компьютер"" означает, что под этим цветом флага может играть только компьютер."
HUMAN_CPU7 	"""Человек или компьютер"" означает, что под этим цветом флага может играть либо человек, либо компьютер.

""Только компьютер"" означает, что под этим цветом флага может играть только компьютер."
HUMAN_CPU8 	"""Человек или компьютер"" означает, что под этим цветом флага может играть либо человек, либо компьютер.

""Только компьютер"" означает, что под этим цветом флага может играть только компьютер."
HANDICAP1 	Усложняет положение данного игрока, уменьшая на 15%/30% его исходные ресурсы.
HANDICAP2 	Усложняет положение данного игрока, уменьшая на 15%/30% его исходные ресурсы.
HANDICAP3 	Усложняет положение данного игрока, уменьшая на 15%/30% его исходные ресурсы.
HANDICAP4 	Усложняет положение данного игрока, уменьшая на 15%/30% его исходные ресурсы.
HANDICAP5 	Усложняет положение данного игрока, уменьшая на 15%/30% его исходные ресурсы.
HANDICAP6 	Усложняет положение данного игрока, уменьшая на 15%/30% его исходные ресурсы.
HANDICAP7 	Усложняет положение данного игрока, уменьшая на 15%/30% его исходные ресурсы.
HANDICAP8 	Усложняет положение данного игрока, уменьшая на 15%/30% его исходные ресурсы.
TOWN_LEFT1 	Позволяет вам выбрать исходный тип города.
TOWN_LEFT2 	Позволяет вам выбрать исходный тип города.
TOWN_LEFT3 	Позволяет вам выбрать исходный тип города.
TOWN_LEFT4 	Позволяет вам выбрать исходный тип города.
TOWN_LEFT5 	Позволяет вам выбрать исходный тип города.
TOWN_LEFT6 	Позволяет вам выбрать исходный тип города.
TOWN_LEFT7 	Позволяет вам выбрать исходный тип города.
TOWN_LEFT8 	Позволяет вам выбрать исходный тип города.
TOWN_RITE1 	Позволяет вам выбрать исходный тип города.
TOWN_RITE2 	Позволяет вам выбрать исходный тип города.
TOWN_RITE3 	Позволяет вам выбрать исходный тип города.
TOWN_RITE4 	Позволяет вам выбрать исходный тип города.
TOWN_RITE5 	Позволяет вам выбрать исходный тип города.
TOWN_RITE6 	Позволяет вам выбрать исходный тип города.
TOWN_RITE7 	Позволяет вам выбрать исходный тип города.
TOWN_RITE8 	Позволяет вам выбрать исходный тип города.
HERO_LEFT1 	Позволяет вам выбрать исходный тип героя в зависимости от типа города.
HERO_LEFT2 	Позволяет вам выбрать исходный тип героя в зависимости от типа города.
HERO_LEFT3 	Позволяет вам выбрать исходный тип героя в зависимости от типа города.
HERO_LEFT4 	Позволяет вам выбрать исходный тип героя в зависимости от типа города.
HERO_LEFT5 	Позволяет вам выбрать исходный тип героя в зависимости от типа города.
HERO_LEFT6 	Позволяет вам выбрать исходный тип героя в зависимости от типа города.
HERO_LEFT7 	Позволяет вам выбрать исходный тип героя в зависимости от типа города.
HERO_LEFT8 	Позволяет вам выбрать исходный тип героя в зависимости от типа города.
HERO_RITE1 	Позволяет вам выбрать исходный тип героя в зависимости от типа города.
HERO_RITE2 	Позволяет вам выбрать исходный тип героя в зависимости от типа города.
HERO_RITE3 	Позволяет вам выбрать исходный тип героя в зависимости от типа города.
HERO_RITE4 	Позволяет вам выбрать исходный тип героя в зависимости от типа города.
HERO_RITE5 	Позволяет вам выбрать исходный тип героя в зависимости от типа города.
HERO_RITE6 	Позволяет вам выбрать исходный тип героя в зависимости от типа города.
HERO_RITE7 	Позволяет вам выбрать исходный тип героя в зависимости от типа города.
HERO_RITE8 	Позволяет вам выбрать исходный тип героя в зависимости от типа города.
RES_LEFT1 	Позволяет выбрать исходный бонус для героя.
RES_LEFT2 	Позволяет выбрать исходный бонус для героя.
RES_LEFT3 	Позволяет выбрать исходный бонус для героя.
RES_LEFT4 	Позволяет выбрать исходный бонус для героя.
RES_LEFT5 	Позволяет выбрать исходный бонус для героя.
RES_LEFT6 	Позволяет выбрать исходный бонус для героя.
RES_LEFT7 	Позволяет выбрать исходный бонус для героя.
RES_LEFT8 	Позволяет выбрать исходный бонус для героя.
RES_RITE1 	Позволяет выбрать исходный бонус для героя.
RES_RITE2 	Позволяет выбрать исходный бонус для героя.
RES_RITE3 	Позволяет выбрать исходный бонус для героя.
RES_RITE4 	Позволяет выбрать исходный бонус для героя.
RES_RITE5 	Позволяет выбрать исходный бонус для героя.
RES_RITE6 	Позволяет выбрать исходный бонус для героя.
RES_RITE7 	Позволяет выбрать исходный бонус для героя.
RES_RITE8 	Позволяет выбрать исходный бонус для героя.
HERO_SETTING_1 	Нажмите здесь, чтобы выбрать этот цвет флага для себя.
HERO_SETTING_2 	Нажмите здесь, чтобы выбрать этот цвет флага для себя.
HERO_SETTING_3 	Нажмите здесь, чтобы выбрать этот цвет флага для себя.
HERO_SETTING_4 	Нажмите здесь, чтобы выбрать этот цвет флага для себя.
HERO_SETTING_5 	Нажмите здесь, чтобы выбрать этот цвет флага для себя.
HERO_SETTING_6 	Нажмите здесь, чтобы выбрать этот цвет флага для себя.
HERO_SETTING_7 	Нажмите здесь, чтобы выбрать этот цвет флага для себя.
HERO_SETTING_8 	Нажмите здесь, чтобы выбрать этот цвет флага для себя.
TOWN_SETTING_1 	TOWN_SETTING_1 
TOWN_SETTING_2 	TOWN_SETTING_2 
TOWN_SETTING_3 	TOWN_SETTING_3 
TOWN_SETTING_4 	TOWN_SETTING_4 
TOWN_SETTING_5 	TOWN_SETTING_5 	
TOWN_SETTING_6 	TOWN_SETTING_6 	
TOWN_SETTING_7 	TOWN_SETTING_7 	
TOWN_SETTING_8 	TOWN_SETTING_8 	
const_create_map,		
const_map_size_label,	Выбор размера карты.	
const_small_map,	"Создать маленькую карту.
(36 х 36 клеток)"	
const_medium_map,	"Создать среднюю карту.
(72 х 72 клетки)"	
const_large_map,	"Создать большую карту.
(108 х 108 клеток)"	
const_huge_map,	"Создать очень большую карту.
(144 х 144 клетки)"	
const_map_levels,	Выбрать одно- или двухуровневую карту.	
const_human_positions_label,	Выбор числа позиций для игроков-людей.	
const_1_human,	Создать 1 игрока-человека.	
const_2_humans,	Создать 2 игрока-человека.	
const_3_humans,	Создать 3 игрока-человека.	
const_4_humans,	Создать 4 игрока-человека.	
const_5_humans,	Создать 5 игроков-людей.	
const_6_humans,	Создать 6 игроков-людей.	
const_7_humans,	Создать 7 игроков-людей.	
const_8_humans,	Создать 8 игроков-людей.	
const_random_humans,	Случайный выбор количества игроков-людей.	
const_human_teams_label,	Выбор количества команд для игроков-людей.	
const_no_human_teams,	Каждый сам за себя.	
const_1_human_team,	Составить 1 команду игроков-людей.	
const_2_human_teams,	Составить 2 команды игроков-людей.	
const_3_human_teams,	Составить 3 команды игроков-людей.	
const_4_human_teams,	Составить 4 команды игроков-людей.	
const_5_human_teams,	Составить 5 команд игроков-людей.	
const_6_human_teams,	Составить 6 команд игроков-людей.	
const_7_human_teams,	Составить 7 команд игроков-людей.	
const_random_human_teams,	Случайный выбор количества команд игроков-людей.	
const_computer_positions_label,	Выбор числа позиций для компьютера.	
const_no_computers,	Не создавать компьютерных оппонентов.	
const_1_computer,	Создать 1 позицию для компьютерного оппонента.	
const_2_computers,	Создать 2 позиции для компьютерных оппонентов.	
const_3_computers,	Создать 3 позиции для компьютерных оппонентов.	
const_4_computers,	Создать 4 позиции для компьютерных оппонентов.	
const_5_computers,	Создать 5 позиций для компьютерных оппонентов.	
const_6_computers,	Создать 6 позиций для компьютерных оппонентов.	
const_7_computers,	Создать 7 позиций для компьютерных оппонентов.	
const_random_computers,	Случайный выбор количества компьютерных оппонентов.	
const_computer_teams_label,	Выбор количества команд компьютерных оппонентов.	
const_no_computer_teams,	Каждый сам за себя.	
const_1_computer_team,	Составить 1 команду компьютерных оппонентов.	
const_2_computer_teams,	Составить 2 команды компьютерных оппонентов.	
const_3_computer_teams,	Составить 3 команды компьютерных оппонентов.	
const_4_computer_teams,	Составить 4 команды компьютерных оппонентов.	
const_5_computer_teams,	Составить 5 команд компьютерных оппонентов.	
const_6_computer_teams,	Составить 6 команд компьютерных оппонентов.	
const_random_computer_teams,	Случайный выбор количества команд компьютерных оппонентов.	
const_water_label,	Выбор соотношения воды и суши.	
const_no_water,	Минимум или отсутствие воды.	
const_normal_water,	Континент, окруженный водой.	
const_islands,	Много островов.	
const_random_water,	Случайное соотношение воды и суши.	
const_monster_strength_label,	Выбор уровня относительной силы монстров на карте.	
const_weak_monsters,	Слабые монстры.	
const_normal_monsters,	Обычные монстры.	
const_strong_monsters,	Сильные монстры.	
const_random_monsters,	Случайный выбор силы монстров.	
const_show_saved_random_maps,	Показать последние созданные случайные карты.	
SLIDER_CHATWINDOW 	Прокрутить текст чата.	
SLIDER_FILEMENU 	Прокрутить список сценариев или сохраненных игр.	
SLIDER_DURATION 	Настройка продолжительности хода игроков.	
PLAYER_HANDICAP_HEADER_ID,	"{Имя, цвет и тип игрока + фора}

Каждая позиция, которую может занять игрок-человек, отмечена слева флажком. Нажатием левой кнопки мыши на флажке вы можете перенести его в другое место. Нажатием на поле имени, вы можете изменить имя игрока.

Каждый игрок может дать другим фору путем нажатия кнопки ""Фора"". В игре используются три типа форы: без форы, небольшая фора, большая фора. При выборе небольшой или большой форы у игрока уменьшается количество исходных ресурсов.
"																						
TURN_DURATION_HEADER_ID,	"{Продолжительность хода игрока}

При помощи ползунка вы можете установить продолжительность хода игрока. В этом случае таймер отсчитывает продолжительность хода игрока вне боя. В режиме боя таймер прекращает отсчет.

В игре используются следующие продолжительности хода: 1, 2, 4, 6, 8, 10, 15, 20, 25, и 30 мин.
Продолжительность ""Без ограничения"" устанавливается по умолчанию.
"																						
STARTING_TOWN_HEADER_ID,	"{Исходный город}

Каждый игрок может начать игру либо с городом, либо без города. Возможными вариантами могут быть Замок, Оплот, Башня, Инферно, Некрополис, Темница, Цитадель или Крепость, а также случайный выбор из перечисленных. 

Если вы начинаете без героя, то эти установки могут использоваться при выборе расы исходного героя.

Нажав правой кнопкой мыши на изображении города, можно увидеть базовые типы существ данного города.
"																						
STARTING_TOWN_HEADER_W_CONFLUX_ID,	"{Исходный город}

Каждый игрок может начать игру либо с городом, либо без города. Возможными вариантами могут быть Замок, Оплот, Башня, Инферно, Некрополис, Темница, Цитадель, Крепость или Сопряжение, а также случайный выбор из перечисленных.

Если вы начинаете без героя, то эти установки могут использоваться при выборе расы исходного героя.

Нажав правой кнопкой мыши на изображении города, можно увидеть базовые типы существ данного города.
"																						
STARTING_HERO_HEADER_ID,	"{Исходный герой}

Каждый игрок может начать игру с героем или без него. Иногда данная опция может быть недоступна или совсем отсутствовать. Иногда вам на выбор может быть предложено до шестнадцати героев. Если вам доступна опция ""Исходный город"", то вы можете переключать доступный класс героев.

Нажав правой кнопкой мыши на изображении героя, можно увидеть имя героя, класс и его особенности.
"																						
STARTING_BONUS_HEADER_ID,	"{Исходный бонус}

В качестве исходного бонуса вы можете выбрать случайный артефакт, дополнительное золото или дополнительные ресурсы.
"																						
																							
Multiplayer Selection	Multiplayer Selection																						
																							
Онлайн-лобби	"{Онлайн-лобби}

Игра через интернет с помощью специального лобби-сервера."																						
За одним компьютером	"{За одним компьютером}

Игра для двух или более человек за одним компьютером, поочередно."																						
IPX	"{IPX}

Игра для двух или более человек со своих компьютеров через локальную сеть, по протоколу IPX."																						
TCP/IP	"{TCP/IP}

Игра для двух или более человек со своих компьютеров через локальную сеть или интернет, по протоколу TCP/IP."																						
Модем	"{Модем}

Игра для двух человек со своих компьютеров через модемное соединение (в современных реалиях – неактуально)."																						
Прямое соединение	"{Прямое соединение}

Игра для двух человек со своих компьютеров через нуль-модем (прямое соединение двух компьютеров через COM-порт; в современных реалиях – неактуально)."																						
Сервер	"{Сервер}

Создание нового сеанса сетевой игры, к которому смогут подключиться другие игроки со своих компьютеров."																						
Подключение к игре	"{Подключение к игре}

Подключение к существующему сеансу сетевой игры, созданному другим игроком на своем компьютере."
Поиск игры	"{Поиск игры}

Позволяет указать определенный IP-адрес, для установления соединения с желаемым хостом (сервером)."
GAMENAME 1	GAMENAME 1
GAMENAME 2	GAMENAME 2
GAMENAME 3	GAMENAME 3
GAMENAME 4	GAMENAME 4
GAMENAME 5	GAMENAME 5
GAMENAME 6	GAMENAME 6
GAMENAME 7	GAMENAME 7
GAMENAME 8	GAMENAME 8
GAMENAME 9	GAMENAME 9
GAMENAME 10	GAMENAME 10
GAMENAME 11	GAMENAME 11
GAMENAME 12	GAMENAME 12
Прокрутить доступные игры	Прокрутить список доступных игр.
	
Отмена	"{Отмена}

Вернуться в предыдущее меню.
(горячая клавиша – Esc)"																						
																							
Adventure Map Window																							
Карта мира	"{Карта мира}

Мир показывается в уменьшенном виде. Нажмите левую кнопку мыши в любом месте окна, и основное окно будет отцентрировано на этой области, или можете переместить рамку, чтобы передвинуть основное окно."																						
Окно статуса	SELECTION WINDOW																						
Обзор королевства	"{Обзор королевства}

Показывает города и героев вашего королевства.
(горячая клавиша – K/Л)"																						
Обзор наземного/подземного мира	"{Обзор наземного/подземного мира}

Переключает основное окно между картами двух уровней.
(горячая клавиша – U/Г)"																						
Журнал заданий	"{Журнал заданий}

Здесь отображается список текущих заданий.
(горячая клавиша – Q/Й)"																						
Усыпить/Разбудить героя	"{Усыпить/Разбудить героя}

Усыпляет выбранного героя
(горячая клавиша – Z/Я)
или пробуждает спящего
(горячая клавиша – W/Ц)
Все спящие герои не переключаются
кнопкой ""Следующий герой""."																						
Переместить героя	"{Переместить героя}

Перемещает текущего героя по выбранному пути.
(горячая клавиша – M/Ь)"																						
Направить заклинание	"{Направить заклинание}

Направляет небоевые заклинания.
(горячая клавиша – C/С)"																						
Игровые действия	"{Игровые действия}

Позволяет искать Грааль, посмотреть головоломку, карту мира и информацию о сценарии. В режиме сетевой игры вы сможете посмотреть последний ход вашего оппонента.
(горячая клавиша – A/Ф)"																						
Системные настройки	"{Системные настройки}

Позволяет показать и изменить текущие игровые настройки.
(горячая клавиша – O/Щ)"																						
Следующий герой	"{Следующий герой}

Выбирает следующего героя, у которого еще остался запас хода. Спящие герои игнорируются.
(горячая клавиша – H/Р)"																						
Конец хода	"{Конец хода}

Заканчивает текущий ход.
(горячая клавиша – E/У)"																						
Прокрутить список героев	"{Список героев}

Прокрутить список доступных героев вверх.
(горячая клавиша – H/Р)"																						
Прокрутить список героев	"{Список героев}

Прокрутить список доступных героев вниз.
(горячая клавиша – H/Р)"																						
Портрет героя	"{Портрет героя}

Нажмите один раз, чтобы выбрать этого героя и отцентрировать экран на нем. Нажмите еще раз, чтобы войти в экран героя."																						
Прокрутить список городов	"{Список городов}

Прокрутить список доступных городов вверх.
(горячая клавиша – T/Е)"																						
Прокрутить список городов	"{Список городов}

Прокрутить список доступных городов вниз.
(горячая клавиша – T/Е)"																						
Просмотр города	"{Просмотр города}

Нажмите один раз, чтобы отцентрировать экран на этом городе. Нажмите еще раз, чтобы войти в экран города."																						
Золото	Количество золота в вашей сокровищнице.																						
Древесина	Общее количество древесины королевства.																						
Ртуть	Общее количество ртути королевства.																						
Руда	Общее количество руды королевства.																						
Сера	Общее количество серы королевства.																						
Кристаллы	Общее количество кристаллов королевства.																						
Самоцветы	Общее количество самоцветов королевства.																						
Дата	"{Дата}

Месяц, неделя и день игры."																						
ROLLOVER	ROLLOVER																						
																							
System Options	System Options																						
Главное меню	"{Главное меню}

Прервать игру и вернуться в главное меню.
(горячая клавиша на карте мира – Esc; в окне опций – M/Ь)"
Загрузить игру	"{Загрузить игру}

Загрузить сохраненную игру.
(горячая клавиша – L/Д)"
Сохранить игру	"{Сохранить игру}

Сохранить текущую игру.
(горячая клавиша – S/Ы)"
Начать заново	"{Начать заново}

Начать текущую игру заново.
(горячая клавиша на карте мира – N/Т – выход в меню "Новая игра"; в окне опций – R/К – перезапуск текущего сценария)"
Выйти из игры	"{Выйти из игры}

Выйти из игры ""Герои Меча и Магии III"" в операционную систему.
(горячая клавиша на карте мира – Alt+F4; в окне опций – Q/Й)"
Вернуться в игру	"{Вернуться в игру}

Вернуться на экран карты.
(горячая клавиша в окне опций – Esc)"
MUSIC_VOLUME_0_ID,	Отключить музыку.
MUSIC_VOLUME_1_ID,	Громкость музыки 1.
MUSIC_VOLUME_2_ID,	Громкость музыки 2.
MUSIC_VOLUME_3_ID,	Громкость музыки 3.
MUSIC_VOLUME_4_ID,	Громкость музыки 4.
MUSIC_VOLUME_5_ID,	Громкость музыки 5.
MUSIC_VOLUME_6_ID,	Громкость музыки 6.
MUSIC_VOLUME_7_ID,	Громкость музыки 7.
MUSIC_VOLUME_8_ID,	Громкость музыки 8.
MUSIC_VOLUME_9_ID,	Громкость музыки 9.
EFFECTS_VOLUME_0_ID,	Отключить звуковые эффекты.
EFFECTS_VOLUME_1_ID,	Громкость звуковых эффектов 1.
EFFECTS_VOLUME_2_ID,	Громкость звуковых эффектов 2.
EFFECTS_VOLUME_3_ID,	Громкость звуковых эффектов 3.
EFFECTS_VOLUME_4_ID,	Громкость звуковых эффектов 4.
EFFECTS_VOLUME_5_ID,	Громкость звуковых эффектов 5.
EFFECTS_VOLUME_6_ID,	Громкость звуковых эффектов 6.
EFFECTS_VOLUME_7_ID,	Громкость звуковых эффектов 7.
EFFECTS_VOLUME_8_ID,	Громкость звуковых эффектов 8.
EFFECTS_VOLUME_9_ID,	Громкость звуковых эффектов 9.
MUSIC_TYPE_NONE_ID,	MUSIC_TYPE_NONE_ID,
MUSIC_TYPE_CD_ID,	MUSIC_TYPE_CD_ID,
MUSIC_TYPE_MIDI_ID,	MUSIC_TYPE_MIDI_ID,
HERO_SPEED_WALK_ID,	"Самая медленная скорость перемещения героя по карте (шаг)."
HERO_SPEED_CANTER_ID,	"Медленная скорость перемещения героя по карте (рысь)."
HERO_SPEED_GALLOP_ID,	"Средняя скорость перемещения героя по карте (галоп)."
HERO_SPEED_JUMP_ID,	"Быстрая скорость перемещения героя по карте (прыжки – перемещение без показа анимации)."
AI_SPEED_CANTER_ID,	"Медленная скорость перемещения врага по карте (рысь)."
AI_SPEED_GALLOP_ID,	"Средняя скорость перемещения врага по карте (галоп)."
AI_SPEED_JUMP_ID,	"Быстрая скорость перемещения врага по карте (прыжки – перемещение без показа анимации)."
AI_SPEED_NONE_ID,	Не показывать перемещения врага.
WINDOW_SCROLL_SLOW,	Низкая скорость прокрутки карты.
WINDOW_SCROLL_MEDIUM,	Средняя скорость прокрутки карты.
WINDOW_SCROLL_FAST,	Высокая скорость прокрутки карты.
SHOW_PATH_ID,	"{Показывать путь}

Позволяет отображать на экране путь перемещения героя до того, как он сойдет с места."
MOVE_REMINDER_ID,	"{Напоминать о запасе хода}

Если в конце хода у игрока имеются герои с оставшимся запасом единиц перемещения, будет отображаться окно с запросом на окончание хода."
QUICK_COMBAT_ID,	"{Быстрый бой}

Позволяет компьютеру производить все необходимые для проведения боя подсчеты и показывать игроку лишь результаты боя."
VIDEO_SUBTITLES_ID,	"{Субтитры к видеороликам}

Позволяет включать субтитры для всех видеозаставок."
VIDEO_QUALITY_LOW	"{Видео низкого качества}

Рекомендуется включать этот режим на слабых компьютерах, если просмотр видеозаставок на них затруднен."
VIDEO_QUALITY_HIGH	"{Видео высокого качества}

Рекомендуется включать этот режим на мощных компьютерах, которые способны обрабатывать большие объемы данных и проигрывать полноэкранное видео высокого качества."
TOWN_OUTLINES_ID,	"{Контуры городских зданий}

В окне города, при наведении курсора на любое доступное здание, будут подсвечиваться контуры этой постройки."
ANIMATE_SPELLBOOK_ID,	"{Анимация книги заклинаний}

В окне книги заклинаний будет отображаться анимированный эффект перелистывания страниц."
																							
Adventure Options																							
Показать мир	"{Показать мир}

Показывает мир с высоты птичьего полета.
(горячая клавиша – V/М)"																						
Карта-загадка	"{Карта-загадка}

Просмотр карты-пазла со спрятанным Граалем.
(горячая клавиша – P/З) 
Позволяет вам определить расположение места, где закопан Грааль (примерное или точное – в зависимости от того, как много фрагментов пазла вы сумели открыть, посещая Обелиски, расположенные на карте мира)."																						
Информация о сценарии	"{Информация о сценарии}

Просмотр информации о текущем сценарии.
(горячая клавиша – I/Ш)"																						
Копать	"{Копать}

Произвести раскопки потерянного Грааля текущим героем в точке его нахождения.
(горячая клавиша – D/В)
Ваш герой должен иметь полный запас единиц перемещения или подождать до начала следующего дня, чтобы приступить к раскопкам. И, конечно же, сначала вы должны определить место нахождения Грааля при помощи Карты-загадки."																						
Повторить ход врага	"{Повторить ход врага}

Просмотр действий противника на видимой части карты, произошедшие после окончания вашего последнего хода.
(горячая клавиша в окне опций сценария – R/К)"																						
ROLLOVER	ROLLOVER																						
ОК	"{ОК}

Вернуться на основной экран."																						
																							
Combat Window	Combat Window																						
Сдаться	"{Сдаться}

Герой может сдаться врагу. Чтобы покинуть поле боя, ему придется заплатить. После этого до начала новой недели героя можно нанять в таверне любого союзного города вместе со всеми войсками и артефактами, которые у него были.
(горячая клавиша – S/Ы)"																						
Отступить	"{Отступить}

Герой сбежит с поля боя и потеряет войска, но до начала новой недели его можно будет нанять в таверне любого союзного города вместе со всеми артефактами, которые у него были.
(горячая клавиша – R/К)"																						
Настройки боя	"{Настройки боя}

Позволяет просматривать и изменять текущие настройки боя.
(горячая клавиша – O/Щ)"																						
Автобой	"{Автобой}

Позволяет компьютеру вести за вас бой. Чтобы выйти из режима автобоя, нажмите левую кнопку мыши – управление войсками будет передано вам на ближайшем ходу вашего отряда.
(горячая клавиша – A/Ф)"																						
	"{Окно информации}

В этом окне появляется информация, подробно комментирующая ход сражения."																						
	"{Стрелки прокрутки}

Позволяют просматривать информацию, появляющуюся во время боя.
(горячие клавиши – стрелки курсора вверх и вниз)"																						
Направить заклинание	"{Направить заклинание}

Открывает книгу заклинаний героя, позволяя ему направить выбранное заклинание.
(горячая клавиша – C/С)"																						
Ждать	"{Ждать}

Задерживает ход отряда до тех пор, пока не походят все остальные отряды.
(горячая клавиша – W/Ц)"																						
Обороняться	"{Обороняться}

Отряд пропускает ход в этом раунде, но при этом его уровень защиты увеличивается на 20%.
(горячая клавиша – Пробел или D/В)"																						
Следующий отряд существ	"{Следующий отряд существ}

Оставить выбранный отряд на месте, если его не нужно перемещать или требуется подождать, пока не будут расставлены остальные войска.
(горячая клавиша – Пробел)"																						
Начать битву	"{Начать битву}

Закончить расстановку войск и перейти к бою.
(горячая клавиша – Enter)"																						
																							
Combat Options	Combat Options																						
Вернуться в игру	"{Вернуться в игру}

Выйти из экрана настроек боя.
(горячая клавиша в окне опций – Esc)"																						
По умолчанию	"{По умолчанию}

Выставить настройки боя, заданные по умолчанию."																						
MUSIC_VOLUME_0_ID,	Отключить музыку.																						
MUSIC_VOLUME_1_ID,	Громкость музыки 1.																						
MUSIC_VOLUME_2_ID,	Громкость музыки 2.																						
MUSIC_VOLUME_3_ID,	Громкость музыки 3.																						
MUSIC_VOLUME_4_ID,	Громкость музыки 4.																						
MUSIC_VOLUME_5_ID,	Громкость музыки 5.																						
MUSIC_VOLUME_6_ID,	Громкость музыки 6.
MUSIC_VOLUME_7_ID,	Громкость музыки 7.
MUSIC_VOLUME_8_ID,	Громкость музыки 8.
MUSIC_VOLUME_9_ID,	Громкость музыки 9.
EFFECTS_VOLUME_0_ID,	Отключить звуковые эффекты.
EFFECTS_VOLUME_1_ID,	Громкость звуковых эффектов 1.
EFFECTS_VOLUME_2_ID,	Громкость звуковых эффектов 2.
EFFECTS_VOLUME_3_ID,	Громкость звуковых эффектов 3.
EFFECTS_VOLUME_4_ID,	Громкость звуковых эффектов 4.
EFFECTS_VOLUME_5_ID,	Громкость звуковых эффектов 5.
EFFECTS_VOLUME_6_ID,	Громкость звуковых эффектов 6.
EFFECTS_VOLUME_7_ID,	Громкость звуковых эффектов 7.
EFFECTS_VOLUME_8_ID,	Громкость звуковых эффектов 8.
EFFECTS_VOLUME_9_ID,	Громкость звуковых эффектов 9.
MUSIC_TYPE_NONE_ID,	MUSIC_TYPE_NONE_ID,
MUSIC_TYPE_CD_ID,	MUSIC_TYPE_CD_ID,
MUSIC_TYPE_MIDI_ID,	MUSIC_TYPE_MIDI_ID,
AUTO_CREATURES_ID,	"{Существа}

Во время автобоя вашими войсками управляет компьютер."
AUTO_SPELLS_ID,	"{Заклинания}

Во время автобоя ваш герой может направлять заклинания."
AUTO_CATAPULT_ID,	"{Катапульта}

При осаде вражеского замка ваши войска решают, какую часть укреплений подвергнуть огню катапульты. При достаточно высоком уровне навыка ""Баллистика"" вы сами можете выбирать цели для нее.

Если ваш герой владеет навыком ""Баллистика"", то при включении режима ""Автобой"" выбор цели осуществляется компьютером."
AUTO_BALLISTA_ID,	"{Баллиста}

Во время боя ваши войска определяют, на какой вражеский отряд направить огонь баллисты. При достаточно высоком уровне навыка ""Артиллерия"" вы сами можете это делать.

Если ваш герой владеет навыком ""Артиллерия"", то при включении режима ""Автобой"" выбор цели осуществляется компьютером."
AUTO_FIRST_AID_TENT_ID,	"{Палатка первой помощи}

Во время боя ваши войска, оказывающие первую помощь, сами выбирают того, кто в ней нуждается. При достаточно высоком уровне владения навыком ""Лечение"", вы сами можете делать выбор.

Если ваш герой владеет навыком ""Лечение"", то при включении режима ""Автобой"" выбор осуществляет компьютер."
ANIMATION_SPEED_0_ID,	Низкая скорость анимации.
(медленное перемещение существ)
ANIMATION_SPEED_1_ID,	Средняя скорость анимации.
(нормальное перемещение существ)
ANIMATION_SPEED_2_ID,	Высокая скорость анимации.
(быстрое перемещение существ)
CREATURE_INFO_STATS_ID,	"{Все данные}

При наведении курсора мыши на какой-либо отряд появится окно, отображающее информацию о численности существ, их основных боевых характеристиках и заклинаниях, действующих на отряд в данный момент. Также, в момент выбора цели, внизу будет выводиться подсказка о возможном уроне, который ваш текущий отряд сможет нанести доступному для атаки отряду противника.
(горячая клавиша – F5)"
CREATURE_INFO_SPELLS_ID,	"{Только заклинания}

Нажатие правой кнопки мыши на каком-либо отряде выводит на экран только заклинания, действующие на него в данный момент. Также, в момент выбора цели, внизу будет выводиться подсказка о возможном уроне, который ваш текущий отряд сможет нанести доступному для атаки отряду противника.
(горячая клавиша – F5)"
VIEW_HEX_ID,	"{Показать сетку}

Показывает наложенную на поле боя сетку, четко выделяющую все клетки, доступные для перемещения на них отрядов существ.
(горячая клавиша – F6)"
MOVEMENT_SHADOW_ID,	"{Затенить клетку}

Затеняет участки поля боя, куда может переместиться текущий отряд.
(горячая клавиша – F8)"
SHADOW_CURSOR_ID,	"{Затенить курсор}

Затеняет клетку, на которую наведен курсор мыши.
(горячая клавиша – F7)"
ANIMATE_SPELLBOOK_ID,	"{Анимация книги заклинаний}

Сопровождает переворачивание страниц в книге заклинаний анимационным эффектом."
	
View Army	View Army																						
Название существа	Название существа.																						
Количество существ	Количество существ в отряде.																						
Навык Атаки	Навык Атаки.																						
Навык Защиты	Навык Защиты.																						
Остаток выстрелов	Количество оставшихся выстрелов.																						
Наносимый урон	Наносимый урон.																						
Здоровье	Здоровье.																						
Остаток здоровья	Оставшееся здоровье.																						
Скорость	Скорость.																						
Боевой дух	Боевой дух.																						
Удача	Удача.																						
Наложенные заклинания	Наложенные заклинания.																						
Уволить	"{Уволить}

Уволить выбранный отряд существ из текущей армии.
(горячая клавиша – D/В)"																						
Улучшить	"{Улучшить}

Улучшить выбранный отряд существ.
(горячая клавиша – U/Г)"																						
ОК	"{ОК}

Вернуться в предыдущее окно.
(горячая клавиша – Esc или Enter)"																						
Заклинание сказочного дракона	"{Заклинание сказочного дракона}

Направить заклинание сказочного дракона."																						
Spell Book	Spell Book																						
Предыдущая страница	"Вернуться на предыдущую страницу.
(горячая клавиша – стрелка курсора влево)"																						
Следующая страница	"Перейти на следующую страницу.
(горячая клавиша – стрелка курсора вправо)"																						
Небоевые заклинания	"Показать небоевые заклинания.
(горячая клавиша – A/Ф)"																						
Боевые заклинания	"Показать боевые заклинания.
(горячая клавиша – C/С)"																						
Заклинания магии Воздуха	"Показать заклинания магии Воздуха.
(переход на закладки других школ магии – стрелками курсора вверх и вниз)"																						
Заклинания магии Огня	"Показать заклинания магии Огня.
(переход на закладки других школ магии – стрелками курсора вверх и вниз)"																						
Заклинания магии Воды	"Показать заклинания магии Воды.
(переход на закладки других школ магии – стрелками курсора вверх и вниз)"																						
Заклинания магии Земли	"Показать заклинания магии Земли.
(переход на закладки других школ магии – стрелками курсора вверх и вниз)"																						
Все заклинания	"Показать заклинания всех школ магии.
(переход на закладки отдельных школ магии – стрелками курсора вверх и вниз)"																						
Очки магии	Остаток очков магии у героя.																						
Выход	"Закрыть книгу заклинаний.
(горячая клавиша – Esc или Enter)"																						
																							
CampaignBrief	CampaignBrief																						
																							
CAMPAIGN_NAME	CAMPAIGN_NAME
CAMPAIGN_DESCRIPTION	CAMPAIGN_DESCRIPTION
MAP_NAME	MAP_NAME
MAP_DESCRIPTION	MAP_DESCRIPTION
HERO_FACE	HERO_FACE
Смена героя	Нажмите здесь, чтобы поменять исходного героя.
Смена героя	Нажмите здесь, чтобы поменять исходного героя.
Бонус: артефакт	В начале игры исходному герою будет выдан случайный артефакт.
Бонус: золото	В начале игры в сокровищницу вашего королевства добавляется дополнительное золото.
Бонус: ресурсы	В начале игры в сокровищницу вашего королевства добавляются дополнительные ресурсы.
Переиграть	"{Переиграть}

Начать текущую кампанию заново."
Введение	"{Введение}

Показать вводный ролик кампании."
ALLY_FLAG1_ID	Это ваш цвет флага.
ALLY_FLAG2_ID	Это цвет флага ваших союзников.
ALLY_FLAG3_ID	Это цвет флага ваших союзников.
ALLY_FLAG4_ID	Это цвет флага ваших союзников.
ALLY_FLAG5_ID	Это цвет флага ваших союзников.
ALLY_FLAG6_ID	Это цвет флага ваших союзников.
ALLY_FLAG7_ID	Это цвет флага ваших союзников.
ALLY_FLAG8_ID	Это цвет флага ваших союзников.
ENEMY_FLAG1_ID	Это цвет флага ваших врагов.
ENEMY_FLAG2_ID	Это цвет флага ваших врагов.
ENEMY_FLAG3_ID	Это цвет флага ваших врагов.
ENEMY_FLAG4_ID	Это цвет флага ваших врагов.
ENEMY_FLAG5_ID	Это цвет флага ваших врагов.
ENEMY_FLAG6_ID	Это цвет флага ваших врагов.
ENEMY_FLAG7_ID	Это цвет флага ваших врагов.
ENEMY_FLAG8_ID	Это цвет флага ваших врагов.
WHICHMAP_ID	Это размер игровой карты.
MAP_AREA_1	MAP_AREA_1
MAP_AREA_2	MAP_AREA_2
MAP_AREA_3	MAP_AREA_3
MAP_AREA_4	MAP_AREA_4
MAP_AREA_5	MAP_AREA_5
MAP_AREA_6	MAP_AREA_6
MAP_AREA_7	MAP_AREA_7
MAP_AREA_8	MAP_AREA_8
MAP_AREA_9	MAP_AREA_9
MAP_AREA_10	MAP_AREA_10
MAP_AREA_11	MAP_AREA_11
MAP_AREA_12	MAP_AREA_12
MAP_AREA_13	MAP_AREA_13
MAP_AREA_14	MAP_AREA_14
MAP_AREA_15	MAP_AREA_15
MAP_AREA_16	MAP_AREA_16
MAP_AREA_17	MAP_AREA_17
MAP_AREA_18	MAP_AREA_18
MAP_AREA_19	MAP_AREA_19
MAP_AREA_20	MAP_AREA_20																						
MAP_AREA_21	MAP_AREA_21																						
MAP_AREA_22	MAP_AREA_22																						
MAP_AREA_23	MAP_AREA_23																						
MAP_AREA_24	MAP_AREA_24																						
MAP_AREA_25	MAP_AREA_25																						
MAP_AREA_26	MAP_AREA_26																						
MAP_AREA_27	MAP_AREA_27																						
MAP_AREA_28	MAP_AREA_28																						
MAP_AREA_29	MAP_AREA_29																						
MAP_AREA_30	MAP_AREA_30																						
MAP_AREA_31	MAP_AREA_31																						
MAP_AREA_32	MAP_AREA_32																						
																							
CampaignWindow	CampaignWindow																						
																							
Да здравствует королева	Да здравствует королева		
Освобождение	Освобождение		
Трофеи войны	Трофеи войны		
Хвала отцу	Хвала отцу		
Темницы и дьяволы	Темницы и дьяволы		
Да здравствует король	Да здравствует король		
Семена недовольства	Семена недовольства		
Клинок Армагеддона	Клинок Армагеддона		
Кровь дракона	Кровь дракона		
Убийца драконов	Убийца драконов		
Празднество жизни	Празднество жизни		
Безрассудная храбрость	Безрассудная храбрость		
Игра с огнем	Игра с огнем		
Руби и кромсай	Руби и кромсай		
Рождение варвара	Рождение варвара		
Новое начало	Новое начало		
Эликсир жизни	Эликсир жизни																						
Восхождение некроманта	Восхождение некроманта																						
Альянс нечисти	Альянс нечисти																						
Призрак власти	Призрак власти																						
																							
																							
ROLLOVER	ROLLOVER																						
																							
Recruit	Recruit																						
Максимум																							
Нанять																							
Отмена																							
																							
Multiplayer	Multiplayer																						
Флажок	Нажмите здесь, чтобы включить/отключить имя.																						
Введите имя игрока	Укажите имя игрока.																						
ОК																							
Отмена																							
Введите имя сеанса																							
Введите пароль																							
Имя сеанса																							
Введите IP-адрес																							
																							
Sacrifice Window	Sacrifice Window																						
Выход (пожертвования не будут сделаны)	Покинуть алтарь. Все, что находится на алтаре, вернется к герою.																						
Имеющийся артефакт																							
Положить все артефакты из рюкзака на алтарь	Поместить артефакты, находящиеся в рюкзаке героя, на алтарь.																						
Положить все артефакты на алтарь	Поместить все имеющиеся на герое, в его снаряжении и в его рюкзаке артефакты на алтарь.																						
Принести в жертву существ	Перейти в экран принесения в жертву существ. Недоступно для героев с добрым мировоззрением (Замок, Оплот, Башня).																						
Количество существ/очки опыта	Количество существ из отряда, выбранных для жертвоприношения.																						
Выбранные существа																							
Количество существ/очки опыта																							
Количество существ для жертвоприношения																							
Указать количество существ для жертвоприношения	Укажите, сколько существ из выбранного отряда вы желаете принести в жертву.																						
Принести в жертву максимальное количество существ	Поместить на алтарь максимальное количество существ из выбранного отряда.																						
Принести в жертву всех существ из армии вашего героя	Поместить всех существ на алтарь, оставив одного, для получения максимально возможного количества очков опыта.																						
Пожертвовать артефакты	Перейти в экран принесения в жертву артефактов. Недоступно для героев со злым мировоззрением (Инферно, Некрополис, Темница).																						
Количество существ/очки опыта																							
Поместите сюда артефакт для приношения в жертву																							
Количество очков опыта за артефакт																							
Пожертвовать артефакты, которые находятся на алтаре	Пожертвовать все, что находится на алтаре, и получить очки опыта.																						
Пожертвовать существ, которые находятся на алтаре	Пожертвовать все, что находится на алтаре, и получить очки опыта.																						
	Посмотреть вещи в рюкзаке героя.																						
	Посмотреть вещи в рюкзаке героя.																						
																							
Skeleton Transformer	Skeleton Transformer																						
Поместить всех существ в преобразователь скелетов	Поместить всех существ в преобразователь скелетов.																						
Преобразовать выбранных существ в скелетов	Преобразовать выбранных существ в скелетов.																						
Покинуть преобразователь скелетов	Покинуть преобразователь скелетов. Помещенные в преобразователь существа не будут преобразованы в скелетов.																						
																							
Trade Window	Trade Window																						
Заключить сделку																							
Максимум																							
Отдать ресурсы другому игроку																							
Купить артефакты																							
Продать существ																							
Выход																							
																							
Give Resource Window	Give Resource Window																						
Заключить сделку																							
Максимум																							
Обменять ресурсы																							
Купить артефакты																							
Выход																							
																							
Buy Artifact Window	Buy Artifact Window																						
Заключить сделку																							
Обменять ресурсы																							
Отдать ресурсы другому игроку																							
Продать артефакты																							
Выход																							
																							
Sell Artifact Window	Sell Artifact Window																						
Заключить сделку																							
Обменять ресурсы																							
Отдать ресурсы другому игроку																							
Продать артефакты																							
Выход																							
																							
Sell Creature Window	Sell Creature Window																						
Заключить сделку																							
Максимум																							
Обменять ресурсы																							
Отдать ресурсы другому игроку																							
Выход																							
																							
University Window	University Window																						
Отмена	Вернуться к выбору навыков.																						
Покинуть университет	Покинуть университет.																						
	Изучить %s %s, заплатив %d золотых.																						
Не используется... Просто ошибка.																							
Insert all data before this line. Do not alter or delete this line.																							



																							
